a	AH
i	AY
want	W AO N T
what	W AO T
is	IH ZH
the	DH AH
number	N AH M B ER
of	AO F
can	K AE N
you	Y UW
give	G IH V
me	M IY
please	P L IY Z
thank	TH AE N K
thanks	TH AE N K S	
ko	K OW
ke	K EY
par	P ER
pe	P EY
call	K AO L
batao	B AH TH AO
sir	S ER
dr	D OW K T ER
mr	M IH S T ER
professor	P R OW F EH S S ER
mrs	M IH S IH Z
prof	P R OW F
anxiety	AE NG Z AY AH T IY
backpain	B AE K P EY N
bad_mood	B AE D M UW D
bleeding	B L IY D IH NG
bonepain	B OW N P EY N
chestpain	CH EH S T P EY N
cough	K AH F
fever	F IY V ER
headache	HH EH D EY K
headpain	HH EH D P EY N
high_temperature	HH AY T EH M P R AH CH ER
hot	HH AO T
hotness	HH AO T N EH S
insomnia	IH N S AO M N IH AH
irritation	IH R IH T EY SH AH N
jointpain	JH OY N T P EY N
lack_of_hunger	L AE K AO F HH AH NG ER
nausea	N AO Z IH AH
no	N OW
nope	N OW P
nosebleed	N OW Z B L IY D
pain_in_head	P EY N IH N HH EH D
rash	R AE SH
sorethroat	S OW R TH R OW T
temperature	T EH M P R AH CH ER
ya	Y AA
yes	Y EH S
